wwwwwwwwwwwwwww
w0010000000200w
w0wwww0w0wwww0w
w0w  whw0w  w0w
w0w  w0w0w  w0w
w0wwww0w0wwww0w
w0000000000000w
w0w0000w0000w0w
w0w0wwwwwww0w0w
w0w000000000w0w
w0w0ww0w0ww0whw
w000000w000000w
ww0wwwwwwwww0ww
w000000w000000w
w0w0ww0w0ww0w0w
w0w000000000w0w
w0w0wwwwwww0w0w
w0w0000w0000w0w
w000000p000000w
w0wwww0w0wwww0w
w0w  w0w0w  w0w
w0w  w0w0w  whw
w0wwww0w0wwww0w
w0030000000400w
wwwwwwwwwwwwwww
