wwwwwwwwwwwwwww
w1010101010101w
w0w0w0w0w0w0w0w
w0000000000000w
w1010101010101w
w0000000000000w
w1010101010101w
w0000000000000w
w1010101010101w
w0000000000000w
w1010101010101w
w0000000000000w
w1010101010101w
w0000000000000w
w0w0w0w0w0w0w0w
w101010p010101w
w0w0w0w0w0w0w0w
w1010101010101w
w0w0w0w0w0w0w0w
w1010101010101w
w0w0w0w0w0w0w0w
w1010101010101w
w1010101010101w
w0000000000000w
wwwwwwwwwwwwwww
